37	1
Ate_micr	M
Can_adus	M
Can_aure	M
Can_anth	M
Can_latr	B
Can_lupu	B
Can_meso	M
Can_rufu	B
Can_sime	B
Cer_thou	M
Chr_brac	B
Cuo_alpi	B
Dus_aust	B
Lyc_pict	B
Nyc_proc	M
Oto_mega	S
Lyc_culp	M
Lyc_fulv	S
Lyc_gris	S
Lyc_gymn	S
Lyc_sech	S
Lyc_vetu	S
Spe_vena	M
Uro_cine	S
Uro_litt	S
Vul_beng	S
Vul_Cana	S
Vul_cham	S
Vul_cors	S
Vul_ferr	S
Vul_macr	S
Vul_pall	S
Vul_ruep	S
Vul_velo	S
Vul_vulp	M
Vul_zer	S
Vul_lago	S
