37	1
Ate_micr	L
Can_adus	M
Can_aure	H
Can_anth	H
Can_latr	H
Can_lupu	H
Can_meso	H
Can_rufu	H
Can_sime	H
Cer_thou	L
Chr_brac	L
Cuo_alpi	H
Dus_aust	L
Lyc_pict	H
Nyc_proc	M
Oto_mega	M
Lyc_culp	L
Lyc_fulv	L
Lyc_gris	L
Lyc_gymn	L
Lyc_sech	L
Lyc_vetu	L
Spe_vena	H
Uro_cine	L
Uro_litt	L
Vul_beng	M
Vul_Cana	M
Vul_cham	L
Vul_cors	M
Vul_ferr	M
Vul_macr	M
Vul_pall	M
Vul_ruep	M
Vul_velo	M
Vul_vulp	M
Vul_zer	M
Vul_lago	M
